ash	nu
an	ba	zu	su
ka	ag
tu	li
qa	na	ru
be	bi
ti	en
hu	us	ig
zi	gi
si	ra
ab	um	ta
ug	as
in	siIII
am	ne
il	urII	qu
du	ush	ish
ni	ir	sa
is	pa	ma	ashII	shu
la	ad	ssi	ia	i
uII	ga
id	da	sha
she	bu	mu	te
ud	pi
hi	im	aI	ah
u	esh
mi	ul
shi	ri	ar
di	ki
puII	al
me	shuII
ib	ur	ttu
ku	lu	qi	uIII
gu	el	ssu	ub, 	arII
a	e
ssa	ha	un
shaII	iaII
