An1naÌ€	å®‰å¨œ	16	Anna		
BaÌ„liÌ?	å·´é»	20	Paris		
BaÌ„xiÌ„	å·´è¥¿	19	Brazil		
BaÌŒihuoÌ€ DaÌ€loÌ?u	ç™¾è´§å¤§æ¥¼	15	Department Store		
BaÌŒoluoÌ?	ä¿?ç½—	6	Paul		
BeÌŒijiÌ„ng YuÌŒyaÌ?n WeÌ?nhuaÌ€ DaÌ€xueÌ?	åŒ—äº¬è¯­è¨€æ–‡åŒ–å¤§å­¦	8	Beijing Language and Culture University		
ChaÌ?ngcheÌ?ng	é•¿åŸ	5	the Great Wall		
DaÌ€toÌ?ng	å¤§å?Œ	15		name of a Chinese City	
DeÌ?guoÌ?	å¾·å›½	6	Germany		
FaÌŒguoÌ?	æ³•å›½	6	France		
GuÌ€goÌ„ng	æ•…å®«	5	the Forbidden City		
HaÌ€nyuÌŒ	æ±‰è¯­	6	Chinese language		
HaÌ€nziÌ€	æ±‰å­—	14	Chinese character		
HaÌ?nguoÌ?	éŸ©å›½	6	Korea		
LiÌŒ YiÌ„ngnaÌ?n	æ?è‹±ç”·	6		name of a person	
LuoÌ?naÌ€'eÌŒrduoÌ„	ç½—çº³å°”å¤š	19	Ronaldo	a famous Brazilian football player	
QiÌ„ngdaÌŒo	é?’å²›	12		name of a Chinese city and brand of beer	
QuaÌ?njuÌ€deÌ?	å…¨è?šå¾·	17		name of a restaurant famous for its roast duck	
ShaÌ€nghaÌŒi	ä¸Šæµ·	17		name of a Chinese City	
SiÌ€chuaÌ„n	å››å·?	14		name of a Chinese province	
TiaÌ„n'aÌ„nmeÌ?n	å¤©å®‰é—¨	5	the Tian'anmen Square		
WaÌ?ng	ç‹	8		a Chinese Surname	
XiaÌ„ngshaÌ„n	é¦™å±±	18		name of a hill in Beijing	
XiaÌŒoyeÌ€	å°?å?¶	9		name of a person	
XiaÌŒoyuÌŒ	å°?é›¨	8		name of a person	
XiÌ„meÌ?ng	è¥¿è’™	6	Simon		
YiÌ?heÌ?yuaÌ?n	é¢?å’Œå›­	5	the Summer Palace		
ZhaÌ„ng	å¼ 	8		a Chinese surname	
ZhiÌ?meÌŒi	ç›´ç¾	9		name of a person	
ZhoÌ„ngguoÌ?	ä¸­å›½	7	China		
a	å•Š	10		a particle used at the end of a sentence to express enthusiasm	
aÌ€i	çˆ±	19	like		
aÌ€iren	çˆ±äºº	2	husband, wife		
aÌ„njiÌ€ng	å®‰é?™	20	quiet		
ba	å?§	10		a particle forming a leading question which asks for confirmation of a supposition	
baÌ€ba	çˆ¸çˆ¸	2	father		
baÌ€n	å?Š	10	half		
baÌ€ng	æ£’	19	excellent		
baÌ€ngoÌ„ngloÌ?u	åŠå…¬æ¥¼	11	administrative building		
baÌ€ngoÌ„ngshiÌ€	åŠå…¬å®¤	5	office		
baÌ€ntiaÌ„n	å?Šå¤©	20	a long time		
baÌ€ozhiÌŒ	æŠ¥çº¸	20	newspaper		
baÌ?i	ç™½	13	white		
baÌ„	å…«	4	eight		
baÌ„n	ç?­	6	class		
baÌ„ozi	åŒ…å­?	3	stuffed bun		
baÌŒi	ç™¾	4	hundred		
baÌŒo	é¥±	18	full	of eating	
beÌ„i	æ?¯	4	cup; glass		
beÌŒibiaÌ„n	åŒ—è¾¹	11	north		
beÌŒn	æœ¬	4		a measure word for books, etc.	
beÌŒnzi	æœ¬å­?	3	notebook		
bieÌ?de	åˆ«çš„	12	others		
biÌ€ng	ç—…	17	be ill; disease		
biÌŒ	ç¬”	3	pen		
biÌŒjiaÌ€o	æ¯”è¾ƒ	7	quite	relatively	
biÌŒsaÌ€i	æ¯”èµ›	19	match		
buÌ€	ä¸?	1	not		
buÌ€keÌ€qi	ä¸?å®¢æ°”	1	Don't mention it; You're welcome		
buÌ?cuoÌ€	ä¸?é”™	7	not bad		
buÌ?guoÌ€	ä¸?è¿‡	14	but		
caÌ€i	è?œ	14	dish		
caÌ€idaÌ„n	è?œå?•	14	menu		
caÌ?i	æ‰?	20		used before a verb to indicate that something has just happened or it is rather late by general standards	
caÌ„	æ“¦	16	wipe		
caÌ„i	çŒœ	16	guess		
caÌ„njiÌ„nzhiÌŒ	é¤?å·¾çº¸	14	napkin paper		
caÌ„nmoÌ?u	å?‚è°‹	13	advise		
chaÌ€	å·®	10	less than		
chaÌ€ng	å”±	14	sing		
chaÌ?	èŒ¶	3	tea		
chaÌ?ng	å°?	12	taste		
chaÌ?ng	é•¿	7	long		
chaÌ?ngchaÌ?ng	å¸¸å¸¸	8	often		
chaÌ?yeÌ€	èŒ¶å?¶	11	tea leaves; tea		
chaÌŒng	åœº	19		a measure word for matches	
cheÌ€nyiÌ„	è¡¬è¡£	13	shirt		
cheÌ?ngjiÌ€	æˆ?ç»©	7	score		
cheÌ„	è½¦	15	vehicle		
chiÌ„	å?ƒ	3	eat		
choÌ„u(shiÌ?jiaÌ„n)	æŠ½ï¼ˆæ—¶é—´ï¼‰	17	find (time to do)		
choÌ„uti	æŠ½å±‰	11	drawer		
chuaÌ?ng	åºŠ	10	bed		
chuÌ„faÌ„	å‡ºå?‘	10	set out		
chuÌ„ntiaÌ„n	æ˜¥å¤©	18	spring		
chuÌ„zuÌ„ qiÌ€cheÌ„	å‡ºç§Ÿæ±½è½¦	15	taxi		
ciÌ?diaÌŒn	è¯?å…¸	3	dictionary		
coÌ?ng...daÌ€o	ä»...åˆ°	10	from ... to		
coÌ„ngming	è?ªæ˜	6	clever		
daÌ€	å¤§	6	big		
daÌ€hoÌ€utiaÌ„n	å¤§å?å¤©	10	three days from now		
daÌ€i	å¸¦	19	take		
daÌ€jiaÌ„	å¤§å®¶	16	all; everybody		
daÌ€nshiÌ€	ä½†æ˜¯	20	but		
daÌ€o	åˆ°	15	arrive; reach		
daÌ€qiaÌ?ntiaÌ„n	å¤§å‰?å¤©	10	three days ago		
daÌ„ngraÌ?n	å½“ç„¶	9	of course		
daÌŒ(diaÌ€nhuaÌ€)	æ‰“ï¼ˆç”µè¯?ï¼‰	16	make (a call)		
daÌŒ(qiuÌ?)	æ‰“ï¼ˆç?ƒï¼‰	19	play		
daÌŒoyoÌ?u	å¯¼æ¸¸	18	tour guide		
daÌŒsuan	æ‰“ç®—	16	plan		
daÌŒziÌ€	æ‰“å­—	19	type		
de	å¾—	19		a particle	
de	çš„	6	of		
deÌŒi	å¾—	19	should		
deÌŒng	ç­‰	10	wait		
diaÌ€nhuaÌ€	ç”µè¯?	8	telephone		
diaÌ€nshiÌ€	ç”µè§†	7	TV		
diaÌ€nyiÌŒng	ç”µå½±	11	movie		
diaÌ€nyiÌŒngyuaÌ€n	ç”µå½±é™¢	11	cinema		
diaÌŒn	ç‚¹	10	o'clock		
diaÌŒn	ç‚¹	14	order (dishes)		
diÌ€di	å¼Ÿå¼Ÿ	2	younger brother		
diÌ€tieÌŒ	åœ°é“?	15	subway; underground		
diÌŒng	é¡¶	17		a measure word for hats	
doÌ„ngbiaÌ„n	ä¸œè¾¹	11	east		
doÌ„ngtiaÌ„n	å†¬å¤©	18	winter		
doÌ„ngxi	ä¸œè¥¿	12	thing		
doÌ„u	éƒ½	2	both; all		
duaÌŒn	çŸ­	12	short		
duoÌ„	å¤š	7	many; much		
duoÌ„	å¤š	9	over		
duoÌ„shao	å¤šå°‘	4	how much; how many		
duÌ€i	é˜Ÿ	19	team		
duÌ€ibuqiÌŒ	å¯¹ä¸?èµ·	1	I am sorry		
duÌ€imiaÌ€n	å¯¹é?¢	11	opposite side		
duÌ?	è¯»	1	read		
duÌ?sheÌ„ngnÃ¼ÌŒ	ç‹¬ç”Ÿå¥³	9	only daughter		
duÌŒcheÌ„	å µè½¦	20	traffic jam		
eÌ€	é¥¿	2	hungry		
eÌ?r	äºŒ	4	two		
eÌ?rzi	å„¿å­?	9	son		
faÌ€nguaÌŒnr	é¥­é¦†å„¿	11	restaurant		
faÌ?ngjiaÌ„n	æˆ¿é—´	8	room		
feÌ„ichaÌ?ng	é?å¸¸	7	very		
feÌ„ijiÌ„	é£æœº	15	plane		
feÌ„n	åˆ†	10	minute		
feÌ„n	åˆ†	4	fen	the fractional monetary unit of China, = 1/10 of a jiao	
feÌ„ng	é£	18	wind		
feÌ„ngjiÌŒng	é£æ™¯	17	scenery		
feÌ„nzhoÌ„ng	åˆ†é’Ÿ	18	minute		
fuÌ€	ä»˜	14	pay		
fuÌ€jiÌ€n	é™„è¿‘	11	nearby; close to		
fuÌ€muÌŒ	çˆ¶æ¯?	9	parents		
fuÌ€qin	çˆ¶äº²	9	father		
fuÌ?wuÌ€yuaÌ?n	æœ?åŠ¡å‘˜	14	attendant; waiter; waitress		
gaÌ€osu	å‘Šè¯‰	14	tell		
gaÌ„ngcaÌ?i	åˆšæ‰?	16	just now		
gaÌ„o	é«˜	7	tall; high		
gaÌ„oxiÌ€ng	é«˜å…´	6	happy		
geÌ€	ä¸ª	4		a measure word most extensively used	
geÌ€ng	æ›´	18	more		
geÌ€zi	ä¸ªå­?	7	height		
geÌ„	æ­Œ	16	song		
geÌ„ge	å“¥å“¥	2	elder brother		
geÌ„n	è·Ÿ	8	with; and		
geÌŒi	ç»™	12	give		
geÌŒi	ç»™	13	for; to; by		
goÌ„nggoÌ€ng qiÌ€cheÌ„	å…¬å…±æ±½è½¦	15	bus		
goÌ„ngliÌŒ	å…¬é‡Œ	15	kilometer		
goÌ„ngsiÌ„	å…¬å?¸	9	company		
goÌ„ngyuaÌ?n	å…¬å›­	17	park		
goÌ„ngzuoÌ€	å·¥ä½œ	9	work; job		
guaÌ€ng	é€›	17	ramble		
guaÌ„	åˆ®	18	blow	of wind	
guaÌ„n	å…³	18	close; shut		
guaÌŒi	æ‹?	15	turn		
guoÌ€	è¿‡	15	cross		
guoÌ€	è¿‡	20	pass		
guoÌ?	å›½	8	country		
guÌ€i	è´µ	8	honourable	polite way of asking people's surname	
guÌ€keÌ€	é¡¾å®¢	16	costumer		
guÌ„jiÌ€	ä¼°è®¡	19	estimate		
haÌ€nyaÌ„zi	æ—±é¸­å­?	19	non-swimmer		
haÌ€o	å?·	13	size		
haÌ€o	å?·	8	number		
haÌ€o(riÌ€)	å?·ï¼ˆæ—¥ï¼‰	10	date		
haÌ€omaÌŒ	å?·ç ?	8	number		
haÌ?i	è¿˜	11	still; also		
haÌ?ishi	è¿˜æ˜¯	12	or		
haÌ?ishi	è¿˜æ˜¯	15		expressing a preference for an alternative	
haÌ?izi	å­©å­?	9	child; children		
haÌŒo	å¥½	1	well; good		
haÌŒo	å¥½	20	very		
haÌŒochiÌ„	å¥½å?ƒ	14	delicious		
haÌŒokaÌ€n	å¥½çœ‹	13	nice; beautiful		
heÌ?	å’Œ	6	and		
heÌ?shiÌ€	å?ˆé€‚	13	suitable		
heÌ„	å–?	3	drink		
heÌ„	å—¬	17	ah		
heÌ„ibaÌŒn	é»‘æ?¿	16	blackboard		
heÌŒn	å¾ˆ	2	very		
hoÌ€u	åš	6	thick		
hoÌ€ubiaÌ„n	å?è¾¹	11	behind		
hoÌ€utiaÌ„n	å?å¤©	10	the day after tomorrow		
hoÌ?ng	çº¢	12	red		
hoÌŒucheÌ„	ç?«è½¦	15	train		
huaÌ€	è¯?	20	word		
huaÌ€n	æ?¢	4	change		
huaÌ„	èŠ±	15	flower		
huoÌ€zheÌŒ	æˆ–è€…	15	or		
huÌ€i	ä¼š	19	can		
huÌ?	å£¶	14	pot		
huÌ?i	å›	18	return; call back		
huÌ?idaÌ?	å›ç­”	16	answer		
jiaÌ€n	ä»¶	13		a measure word for clothing, matters, etc.	
jiaÌ€nmiaÌ€n	è§?é?¢	10	meet		
jiaÌ€o	å?«	8	call		
jiaÌ€oshiÌ€	æ•™å®¤	6	classroom		
jiaÌ€oxueÌ?loÌ?u	æ•™å­¦æ¥¼	11	teaching building		
jiaÌ€qian	ä»·é’±	13	price		
jiaÌ„	å®¶	16		a measure word for shops, stores, etc.	
jiaÌ„	å®¶	9	home; family		
jiaÌ„o	äº¤	16	pay		
jiaÌ„o	æ•™	8	teach		
jiaÌŒnjiaÌ€	å‡?ä»·	16	reduce the prices		
jiaÌŒozi	é¥ºå­?	3	dumpling	with meat and vegetable stuffing	
jieÌ€shaÌ€o	ä»‹ç»?	6	introduce		
jieÌ?huÌ„n	ç»“å©š	18	marry		
jieÌ?zhaÌ€ng	ç»“å¸?	14	get the check		
jieÌŒjie	å§?å§?	2	elder sister		
jieÌŒmeÌ€i	å§?å¦¹	9	sister		
jinniaÌŒn	ä»Šå¹´	9	this year		
jiuÌ€	å°±	5	just		
jiuÌ€shiÌ€	å°±æ˜¯	14	but		
jiuÌŒ	ä¹?	4	nine		
jiÌ€	å¯„	16	post		
jiÌ€n	è¿‘	7	near		
jiÌ€n	è¿›	1	enter		
jiÌ€shuÌ€	æŠ€æœ¯	15	skill		
jiÌ€zheÌŒ	è®°è€…	9	journalist		
jiÌ?le	æ?äº†	6	extremely		
jiÌ„n	æ–¤	12	jin	half kilogram	
jiÌ„ngliÌŒ	ç»?ç?†	9	manager		
jiÌ„ntiaÌ„n	ä»Šå¤©	10	today		
jiÌ„nwaÌŒn	ä»Šæ™š	19	tonight		
jiÌŒ	å‡ 	8	how many		
jiÌŒnzhaÌ„ng	ç´§å¼ 	20	intense		
jueÌ?de	è§‰å¾—	14	feel; think		
juÌ?zi	æ©˜å­?	12	orange		
kaÌ€n	çœ‹	17	call on; visit; see		
kaÌ€n	çœ‹	6	look		
kaÌ€nshaÌ€ngqu	çœ‹ä¸Šå»	18	it looks ...		
kaÌ„feÌ„i	å’–å•¡	3	coffee		
kaÌ„i	å¼€	18	bloom		
kaÌ„i	å¼€	18	leave; start	of a train, bus, ship, etc.	
kaÌŒlaÌ„'oÌ„ukeÌ„i	å?¡æ‹‰OK	14	karaoke		
kaÌŒoshiÌ€	è€ƒè¯•	18	exam; examination		
kaÌŒoyaÌ„	çƒ¤é¸­	17	roast duck		
keÌ€	åˆ»	10	quarter		
keÌ€qi	å®¢æ°”	1	polite; courteous		
keÌ€weÌ?n	è¯¾æ–‡	17	text		
keÌŒ	æ¸´	2	thirsty		
keÌŒ'aÌ€i	å?¯çˆ±	6	lovely		
keÌŒkoÌŒukeÌŒleÌ€	å?¯å?£å?¯ä¹?	3	Coca-cola		
keÌŒneÌ?ng	å?¯èƒ½	16	maybe		
keÌŒshiÌ€	å?¯æ˜¯	15	but		
keÌŒyiÌŒ	å?¯ä»¥	13	can		
koÌ„ngtiaÌ?o	ç©ºè°ƒ	7	air-conditioner		
koÌŒu	å?£	9	mouth	a measure word for people	
kuaÌ€i	å¿«	11	piece; lump	a measure word	
kuaÌ€i	å¿«	15	fast		
kuaÌ€i(yuaÌ?n)	å?—ï¼ˆå…ƒï¼‰	4	yuan	the basic monetary unit of China	
kuaÌ€ngquaÌ?nshuÌŒi	çŸ¿æ³‰æ°´	3	mineral water		
kuaÌ„n	å®½	15	wide		
kuÌ€zi	è£¤å­?	13	trousers; pants		
kuÌŒ	è‹¦	14	bitter		
laÌ€	è¾£	14	hot; peppery		
laÌ?i	æ?¥	6		used before a verb, indicating an intended action	
laÌ?n	è“?	12	blue		
laÌ?nqiuÌ?	ç¯®ç?ƒ	19	basketball		
laÌŒn	æ‡’	18	lazy		
laÌŒo	è€?	13	old		
laÌŒoshiÌ„	è€?å¸ˆ	1	teacher		
le	äº†	12		a particle	
leÌ€i	ç´¯	2	tired		
leÌŒng	å†·	18	cold		
liaÌ€ng	è¾†	12		a measure word for bicycles, cars, etc.	
liaÌ?ng	å‡‰	12	cool		
liaÌ?otiaÌ„nr	è?Šå¤©å„¿	16	chat		
liaÌŒng	ä¸¤	4	two		
liuÌ€	å…­	4	six		
liuÌ?liÌ€	æµ?åˆ©	20	fluent		
liuÌ?xueÌ?sheÌ„ng	ç•™å­¦ç”Ÿ	5	overseas student		
liÌ?	ç¦»	7	from	indicating an interval of space or time	
liÌ?ng	é›¶ï¼ˆï¼?ï¼‰	12	zero; and		
liÌ?ngqiaÌ?n	é›¶é’±	12	small change		
liÌ?njuÌ„	é‚»å±…	20	neighbor		
liÌŒ	é‡Œ	7	in		
liÌŒbiaÌ„n	é‡Œè¾¹	11	in		
liÌŒwuÌ€	ç¤¼ç‰©	15	gift		
loÌ?u	æ¥¼	5	building		
luaÌ€n	ä¹±	13	messy		
luÌ€	è·¯	15	route; No. (for bus); road		
luÌ€koÌŒu	è·¯å?£	15	crossing; intersection		
luÌ€yiÌ„njiÌ„	å½•éŸ³æœº	13	tape-recorder		
lÃ¼ÌŒxiÌ?ng	æ—…è¡Œ	16	travel		
ma	å?—	2		a particle used at the end of a question	
maÌ€i	å?–	12	sell		
maÌ€ozi	å¸½å­?	17	hat		
maÌ?ng	å¿™	2	busy		
maÌ?o(jiaÌŒo)	æ¯›ï¼ˆè§’ï¼‰	4	jiao	the fractional monetary unit of China, = 1/10 of a yuan	
maÌ?poÌ?doÌ€ufu	éº»å©†è±†è…?	14	stir-fried beancurd in hot sauce		
maÌ„ma	å¦ˆå¦ˆ	2	mother		
maÌŒi	ä¹°	3	buy		
maÌŒluÌ€	é©¬è·¯	15	avenue; street		
maÌŒmahuÌ„huÌ„	é©¬é©¬è™è™	7	so-so		
men	é—¨	11		a suffix denoting a plural form	
meÌ€imei	å¦¹å¦¹	2	younger sister		
meÌ?i(yoÌŒu)	æ²¡ï¼ˆæœ‰ï¼‰	7	not have; there be not; have not or did not		
meÌ?iguaÌ„nxi	æ²¡å…³ç³»	1	Don't mention it		
meÌ?n	é—¨	18	door		
meÌ?nkoÌŒu	é—¨å?£	10	entrance		
meÌŒi	æ¯?	8	every		
meÌŒi	ç¾	17	beautiful		
meÌŒiyuaÌ?n	ç¾å…ƒ	4	US dollar		
miaÌ€nbaÌ„o	é?¢åŒ…	3	bread		
miaÌ€ntiaÌ?o	é?¢æ?¡	3	nuddle		
miÌ€miÌ€	ç§˜å¯†	9	secret		
miÌ?ngniaÌ?n	æ˜å¹´	16	next year		
miÌ?ngpiaÌ€n	å??ç‰‡	9	name card		
miÌ?ngtiaÌ„n	æ˜å¤©	10	tomorrow		
miÌ?ngzi	å??å­—	8	name		
miÌŒ	ç±³	15	meter		
miÌŒfaÌ€n	ç±³é¥­	3	cooked rice		
muÌŒqin	æ¯?äº²	9	mother		
naÌ€	é‚£	6	that		
naÌ€ozhoÌ„ng	é—¹é’Ÿ	11	alarm clock		
naÌ€r	é‚£å„¿	5	there		
naÌ?n	ç”·	11	male		
naÌ?n	éš¾	14	difficult		
naÌ?nbiaÌ„n	å?—è¾¹	11	south		
naÌ?npeÌ?ngyou	ç”·æœ‹å?‹	11	boyfriend		
naÌŒ	å“ª	8	which		
naÌŒinai	å¥¶å¥¶	9	grandmother		
naÌŒr	å“ªå„¿	5	where		
ne	å‘¢	2		a particle used at the end of special, alternative, or rhetorical question	
neÌ?ng	èƒ½	19	can		
niaÌ?n	å¹´	10	year		
niaÌ?njiÌ€	å¹´çºª	9	age		
niuÌ?naÌŒi	ç‰›å¥¶	3	milk		
niÌ?n	æ‚¨	1	you	polite	
niÌŒ	ï¿½ä½ 	1	you		
niÌŒmen	ä½ ä»¬	1	you	plural	
nuaÌŒnhuo	æš–å’Œ	18	warm		
nuÌŒliÌ€	åŠªåŠ›	7	hard		
nÃ¼ÌŒ	å¥³	19	female		
nÃ¼ÌŒ'eÌ?r	å¥³å„¿	6	daughter		
nÃ¼ÌŒpeÌ?ngyou	å¥³æœ‹å?‹	19	girlfriend		
paÌ€ng	èƒ–	18	fat		
paÌ?iduÌ€i	æ’é˜Ÿ	16	queue		
paÌ?izi	ç‰Œå­?	13	brand		
paÌ?ngbiaÌ„n	æ—?è¾¹	11	beside		
peÌ?i	é™ª	17	accompany		
peÌ?ngyou	æœ‹å?‹	6	friend		
piaÌ€oliang	æ¼‚äº®	6	pretty; beautiful		
piaÌ?nyi	ä¾¿å®œ	13	cheap		
piÌ?jiuÌŒ	å•¤é…’	3	beer		
piÌ?ng	ç“¶	4	bottle		
piÌ?ngguoÌŒ	è‹¹æœ	12	apple		
qiaÌ?n	é’±	4	money		
qiaÌ?nbiaÌ„n	å‰?è¾¹	11	in the front of		
qiaÌ?ntiaÌ„n	å‰?å¤©	10	the day before yesterday		
qiaÌ„nbiÌŒ	é“…ç¬”	12	pencil		
qiaÌŒo	å·§	18	opportunely; coincidentally		
qiaÌŒokeÌ€liÌ€	å·§å…‹åŠ›	11	chocolate		
qiuÌ?xiÌ„ng	ç?ƒæ˜Ÿ	19	star	football, basketball, etc.	
qiuÌ„tiaÌ„n	ç§‹å¤©	18	autumn		
qiÌ?	éª‘	15	ride		
qiÌ?ng	æ™´	18	sunny		
qiÌ„	ä¸ƒ	4	seven		
qiÌ„nqi	äº²æˆš	18	relative		
qiÌŒ	èµ·	10	get up; rise		
qiÌŒng	è¯·	1	please		
qiÌŒngkeÌ€	è¯·å®¢	14	stand treat		
qiÌŒngweÌ€n	è¯·é—®	5	Excuse me		
quÌ€	å»	5	go		
quÌ?nzi	è£™å­?	17	skirt		
raÌ?nhoÌ€u	ç„¶å?	15	then		
reÌ€	çƒ­	12	hot		
reÌ€nshi	è®¤è¯†	6	meet; know		
reÌ?n	äºº	6	people		
saÌ„n	ä¸‰	4	three		
shaÌ€ng	ä¸Š	17	last		
shaÌ€ngbiaÌ„n	ä¸Šè¾¹	11	on		
shaÌ€ngkeÌ€	ä¸Šè¯¾	10	attend class		
shaÌ€ngwuÌŒ	ä¸Šå?ˆ	10	morning		
shaÌ„n	å±±	18	hill; mount		
shaÌ„ngdiaÌ€n	å•†åº—	5	shop		
shaÌ„o	æ?	14	a little; slightly		
shaÌŒo	å°‘	16	few; little		
sheÌ?nme	ä»€ä¹ˆ	3	what		
sheÌ„ngciÌ?	ç”Ÿè¯?	17	new word		
sheÌ„ngri	ç”Ÿæ—¥	10	birthday		
sheÌ„ntiÌŒ	èº«ä½“	7	health; body		
shiÌ€	äº‹	14	thing; affair; business		
shiÌ€	æ˜¯	6	be		
shiÌ€	è¯•	13	try		
shiÌ?	å??	4	ten		
shiÌ?hou	æ—¶å€™	10	when		
shiÌ?jiaÌ„n	æ—¶é—´	17	time		
shiÌ?taÌ?ng	é£Ÿå ‚	5	dining hall		
shoÌ€u	ç˜¦	18	thin		
shoÌ€uhuoÌ€yuaÌ?n	å”®è´§å‘˜	9	shop assistant		
shuaÌ€i	å¸…	6	handsome		
shuaÌ„ng	å?Œ	13	pair		
shuoÌ„	è¯´	1	say		
shuÌ€ijiaÌ€o	ç?¡è§‰	18	sleep		
shuÌ€ijiaÌ€o	ç?¡è§‰	8	sleep		
shuÌ€ilaÌŒnjiaÌ€o	ç?¡æ‡’è§‰	18	get up late		
shuÌ€yeÌ€	æ ‘å?¶	18	leaf		
shuÌ?i	è°?	8	who; whom		
shuÌ„	ä¹¦	3	book		
shuÌ„	è¾“	19	lose		
shuÌ„baÌ„o	ä¹¦åŒ…	3	schoolbag		
shuÌ„diaÌ€n	ä¹¦åº—	5	bookshop		
shuÌ„fu	èˆ’æœ?	15	comfortable		
shuÌŒ	æ•°	12	count		
siÌ€	å››	4	four		
siÌ„jiÌ„	å?¸æœº	9	driver		
soÌ€ng	é€?	15	send		
soÌ€ng	é€?	20	see sb. off		
suaÌ€n	ç®—	13	calculate		
suaÌ„n	é…¸	12	sour		
suoÌŒyiÌŒ	æ‰€ä»¥	20	so; therefore		
suÌ€i	å²?	9	year (of age)		
suÌ€sheÌ€	å®¿èˆ?	5	dormitory		
suÌ„iraÌ?n	è™½ç„¶	20	though		
taÌ€i	å¤ª	7	very; too		
taÌ?ideÌ„ng	å?°ç?¯	11	desk lamp		
taÌ„	ä»–	2	he; him		
taÌ„	å¥¹	2	she; her		
taÌ„men	ä»–ä»¬	2	they; them		
taÌ„ng	æ±¤	14	soup		
teÌ€bieÌ?	ç‰¹åˆ«	17	especially		
tiaÌ?n	ç”œ	12	sweet		
tiaÌ?o	æ?¡	13		a measure word for long or narrow or thin things	
tiaÌ„n	å¤©	8	day		
tiaÌ„nqiÌ€	å¤©æ°”	18	weather		
tiaÌ„o	æŒ‘	16	choose		
tiÌ„	è¸¢	19	play (football); kick		
tiÌ„ng	å?¬	1	listen		
tiÌ„ng	å?¬	12	tin, can	a measure word	
tiÌ„ngshuoÌ„	å?¬è¯´	14	it is said that		
tiÌŒng	æŒº	7	quite		
toÌ?ngwuÌ„	å?Œå±‹	7	roommate		
toÌ?ngxueÌ?	å?Œå­¦	6	classmate		
toÌ?ufa	å¤´å?‘	7	hair		
tuÌ?shuÌ„guaÌŒn	å›¾ä¹¦é¦†	5	library		
waÌ€ibiaÌ„n	å¤–è¾¹	16	outside		
waÌ?nr	ç©å„¿	17	play		
waÌŒn	æ™š	19	late		
waÌŒn	ç¢—	14	bowl		
waÌŒnfaÌ€n	æ™šé¥­	10	supper		
waÌŒng	å¾€	15	toward		
waÌŒngqiuÌ?	ç½‘ç?ƒ	19	tennis		
waÌŒnshang	æ™šä¸Š	8	evening		
weÌ€i	ä½?	8		a measure word for respected persons	
weÌ€n	é—®	14	ask		
weÌ€ntiÌ?	é—®é¢˜	14	question		
woÌŒ	æˆ‘	2	I		
woÌŒmen	æˆ‘ä»¬	6	we; us		
wuÌŒ	äº”	4	five		
wuÌŒfaÌ€n	å?ˆé¥­	10	lunch		
xiaÌ€	ä¸‹	18	next		
xiaÌ€(yuÌŒ)	ä¸‹ï¼ˆé›¨ï¼‰	16	rain		
xiaÌ€biaÌ„n	ä¸‹è¾¹	11	under		
xiaÌ€keÌ€	ä¸‹è¯¾	10	finish class		
xiaÌ€nmuÌ€	ç¾¡æ…•	19	admire		
xiaÌ€nzaÌ€i	ç°åœ¨	10	now		
xiaÌ€tiaÌ„n	å¤?å¤©	18	summer		
xiaÌ€wuÌŒ	ä¸‹å?ˆ	8	afternoon		
xiaÌ?n	å’¸	14	salty		
xiaÌ„n	å…ˆ	15	first		
xiaÌ„nsheng	å…ˆç”Ÿ	16	sir		
xiaÌŒng	æƒ³	13	would like		
xiaÌŒng	æƒ³	9	miss; think		
xiaÌŒo	å°?	6	small, little	a prefix showing endearment for young people	
xiaÌŒojieÌŒ	å°?å§?	14	waitress; Miss		
xiaÌŒoshiÌ?	å°?æ—¶	20	hour		
xiaÌŒoxueÌ?	å°?å­¦	20	primary school		
xieÌ€xieÌ€	è°¢è°¢	1	thank		
xieÌ?	é‹	11	shoe		
xieÌŒ	å†™	1	write		
xioÌ„ngdiÌ€	å…„å¼Ÿ	9	brother		
xiuÌ„xi	ä¼‘æ?¯	8	rest		
xiÌ€n	ä¿¡	16	letter		
xiÌ€ng	å§“	8	surname		
xiÌ?ng	è¡Œ	10	OK		
xiÌ„biaÌ„n	è¥¿è¾¹	11	west		
xiÌ„hoÌ?ngshiÌ€	è¥¿çº¢æŸ¿	12	tomato		
xiÌ„n	æ–°	6	new		
xiÌ„ngqiÌ„	æ˜ŸæœŸ	10	week		
xiÌ„ngqiÌ„tiaÌ„n(xiÌ„ngqiÌ„riÌ€)	æ˜ŸæœŸå¤©ï¼ˆæ˜ŸæœŸæ—¥ï¼‰	10	Sunday		
xiÌ„nxiaÌ„n	æ–°é²œ	12	fresh		
xiÌ„yaÌ„n(choÌ„uyaÌ„n)	å?¸çƒŸ(æŠ½çƒŸ)	19	smoke		
xiÌŒ	æ´—	17	wash		
xiÌŒhuan	å–œæ¬¢	14	like		
xiÌŒzaÌŒo	æ´—æ¾¡	17	take a shower		
xueÌ?sheng	å­¦ç”Ÿ	6	student		
xueÌ?xiaÌ€o	å­¦æ ¡	7	school		
xueÌ?xiÌ?	å­¦ä¹ 	6	learn		
ya	å‘€	14		a particle	
yaÌ€ngzi	æ ·å­?	13	appearance; shape		
yaÌ€o	è?¯	11	medicine		
yaÌ€o	è¦?	4	want		
yaÌ?nseÌ€	é¢œè‰²	13	color		
yaÌŒnjing	çœ¼ç?›	7	eye		
yaÌŒnjiÌ€ng	çœ¼é•œ	11	glasses		
yeÌ?ye	çˆ·çˆ·	9	grandfather		
yeÌŒ	ä¹Ÿ	2	too, also		
yiÌ€biaÌ„n...yiÌ€biaÌ„n...	ä¸€è¾¹ã€‚ã€‚ã€‚ä¸€è¾¹ã€‚ã€‚ã€‚	16	while		
yiÌ€diaÌŒnr	ä¸€ç‚¹å„¿	13	a little		
yiÌ€ngpiÌ€n	åº”è?˜	16	accept an offer of employment		
yiÌ€qiÌŒ	ä¸€èµ·	8	together		
yiÌ€zhiÌ?	ä¸€ç›´	15	straight		
yiÌ?	å’¦	16	hey		
yiÌ?diÌ€ng	ä¸€å®š	19	surely		
yiÌ?goÌ€ng	ä¸€å…±	12	altogether		
yiÌ?huÌ€ir	ä¸€ä¼šå„¿	20	a while		
yiÌ?ng	èµ¢	19	win		
yiÌ?nhaÌ?ng	é“¶è¡Œ	5	bank		
yiÌ?xiaÌ€r	ä¸€ä¸‹å„¿	6		indicates that an action is brief, slight	
yiÌ?yaÌ?ng	ä¸€æ ·	12	every kind		
yiÌ„	ä¸€	4	one		
yiÌ„fu	è¡£æœ?	17	clothes		
yiÌ„n	é˜´	18	overcast		
yiÌ„nggaÌ„i	åº”è¯¥	15	should		
yiÌ„nweÌ€i	å› ä¸º	20	because		
yiÌ„nyueÌ€	éŸ³ä¹?	16	music		
yiÌ„nyueÌ€huÌ€i	éŸ³ä¹?ä¼š	19	concert		
yiÌ„sheÌ„ng	åŒ»ç”Ÿ	9	doctor		
yiÌ„yuaÌ€n	åŒ»é™¢	5	hospital		
yiÌŒhoÌ€u	ä»¥å?	14	later		
yiÌŒjiÌ„ng	å·²ç»?	17	already		
yiÌŒnliaÌ€o	é¥®æ–™	14	beverage		
yiÌŒqiaÌ?n	ä»¥å‰?	17	before		
yoÌ€ng	ç”¨	13	use		
yoÌ€u...yoÌ€u...	å?ˆ...å?ˆ...	13	both ... and ...		
yoÌ€ubiaÌ„n	å?³è¾¹	11	on the right		
yoÌ?u	æ²¹	14	oil		
yoÌ?ujuÌ?	é‚®å±€	5	post office		
yoÌ?upiaÌ€o	é‚®ç¥¨	16	stamp		
yoÌ?uyoÌŒng	æ¸¸æ³³	19	swim		
yoÌŒu	æœ‰	7	have; there be		
yoÌŒude	æœ‰çš„	16	some		
yoÌŒudiaÌŒnr	æœ‰ç‚¹å„¿	13	a bit		
yoÌŒushiÌ?hou	æœ‰æ—¶å€™	8	sometimes		
yoÌŒuyiÌ€si	æœ‰æ„?æ€?	14	interesting		
yuaÌ?nzhuÌ„biÌŒ	åœ†ç? ç¬”	12	ball-point pen		
yuaÌŒn	è¿œ	7	far		
yueÌ€	æœˆ	10	month		
yuÌ€ndoÌ€ng	è¿?åŠ¨	19	sports; exercises		
yuÌ€xiÌ?	é¢„ä¹ 	17	preview		
yuÌ?kuaÌ€i	æ„‰å¿«	20	happy		
yuÌ?xiaÌ„ngroÌ€usiÌ„	é±¼é¦™è‚‰ä¸?	14	fish-favored shredded pork		
yuÌŒ	é›¨	16	rain		
yuÌŒsaÌŒn	é›¨ä¼	19	umbrella		
zaÌ€i	å†?	12	more; again		
zaÌ€i	åœ¨	5	exist; be at, in or on a place		
zaÌ€ijiaÌ€n	å†?è§?	1	good-bye		
zaÌ?nmen	å’±ä»¬	10	we; us		
zaÌŒo	æ—©	19	early		
zaÌŒofaÌ€n	æ—©é¥­	10	breakfast		
zaÌŒoshang	æ—©ä¸Š	10	morning		
zeÌŒnme	æ€ä¹ˆ	12	how		
zeÌŒnmeyaÌ€ng	æ€ä¹ˆæ ·	7	what about ...		
zhaÌ€opiaÌ€n	ç…§ç‰‡	11	photo		
zhaÌ„i	æ‘˜	12	pick		
zhaÌ„ng	å¼ 	11		a measure word for desks, tables, paper, etc.	
zhaÌ„opiÌ€n	æ‹›è?˜	16	advertise for (new employees)		
zhaÌŒo	æ‰¾	16	look for		
zhaÌŒo(qiaÌ?n)	æ‰¾ï¼ˆé’±ï¼‰	12	give (change)		
zheÌ€	è¿™	6	this		
zheÌ€me	è¿™ä¹ˆ	17	so		
zheÌ€ngzaÌ€i	æ­£åœ¨	16	in process of		
zheÌ€r	è¿™å„¿	8	here		
zheÌ„n	çœŸ	9	very		
zheÌ„nsiÌ„	çœŸä¸?	13	real silk		
zhiÌ€liaÌ€ng	è´¨é‡?	13	quality		
zhiÌ?yuaÌ?n	è?Œå‘˜	9	staff member		
zhiÌ„	å?ª	17		a measure word for animals	
zhiÌ„	æ”¯	12		a measure word for pens, pencils, etc.	
zhiÌ„	æ?	17		a measure word for flowers with stems intact	
zhiÌ„daÌ€o	çŸ¥é?“	5	know		
zhiÌŒ	å?ª	13	only		
zhoÌ€ng	é‡?	15	heavy		
zhoÌ„ngjiaÌ„n	ä¸­é—´	11	in the middle		
zhoÌ„umoÌ€	å‘¨æœ«	15	weekend		
zhoÌŒng	ç§?	13	kind; type		
zhuoÌ„zi	æ¡Œå­?	11	desk; table		
zhuÌ€	ä½?	8	live		
zhuÌŒnbeÌ€i	å‡†å¤‡	20	plan		
ziÌ€	å­—	15	character		
ziÌ€xiÌ?ngcheÌ„	è‡ªè¡Œè½¦	12	bicycle		
zoÌŒu	èµ°	15	go; walk		
zuoÌ€	å?š	19	cook		
zuoÌ€	å?š	8	do		
zuoÌ€	å??	1	sit		
zuoÌ?tiaÌ„n	æ˜¨å¤©	10	yesterday		
zuoÌŒbiaÌ„n	å·¦è¾¹	11	on the left		
zuoÌŒyoÌ€u	å·¦å?³	13	or so; about		
zuÌ€i	æœ€	14	most		
zuÌ€ijiÌ€n	æœ€è¿‘	7	recently		
zuÌ?qiuÌ?	è¶³ç?ƒ	19	football		
