ก็	also; still, anyway; well...
กรกฎาคม	July	กะ-รัก-กะ-ดา-คม
กระดาษ	paper
กระเป๋า	bag
กลับ	return, go/come back	
กลัว	be afraid, fear
กลาง	middle	
กลางวัน	during the day	
ก๋วยเตี๋ยว	(Chinese) noodles	
กว่า	more than, past	
ก่อน	before, former	
กัน	together	optional plural marker on verbs
กันยายน	September	
กับ	with
กาแฟ	coffee	
การ-	nominaliser for activities
กิน	eat, drink	informal
กี่	how many?	with classifier
กี่คน	how many people
กุมภาพันธ์	February	
เก่ง	clever, good, brave	
เกาหลี	Korean
เก้าอี้	chair
เกิด	be born
เกือบ	almost	
ขนม	snack	
ขวา	right
ของ	thing, possessive marker
ของหวาน	dessert, sweets	
ขอโทษ	sorry, excuse me
ขอบคุณ	thank (you)
ขาย	sell
ขาว	white	
ข่าว	news
ข้าว	rice	
ขี่	ride
เขา	he, she, they
เข้าใจ	understand (enter the heart)
เขียน	write	
เขียว	green	
แข็ง	hard	
คง	assumptive marker (preverbal)
คน	person, people	classifier for humans
ครับ	sir, mam (male speaker)
ครึ่ง	half	
ครู	teacher
ความ-	nominaliser for stative verbs (adjectives)
ค่ะ, คะ	sir, mam (female speaker)
ค่ำ	late evening	7-9 pm
คืน	night	
คุณ	you
งาน	work, job	n.
ง่าย	easy
เงิน	silver, money
จะ	will	future, irrealis
จันทร์	Monday, Moon	
จาก	part, leave, from	
จีน	Chinese
เจอ	meet, find	
ฉัน	I	f: neutral, m: informal
ชมพู	pink	
ชอบ	like	v.
ชั่วโมง	hour	
ชา	tea; dumb, without feeling	
ช้า	slow	
ชาย	man, male
ช้าๆ	slow(ly)	
ชื่อ	name, be called
เช่นกัน	same (to you)
เช้า	morning	
ใช่	right
ซ้าย	left
ญี่ปุ่น	Japanese
ด้วย	also, too, with	instrumental, comitative
ด้วยกัน	together	
ดอล, ดอลลาร์	Dollar
ดำ	black	
ดิฉัน, ฉัน	I (female speaker)
ดินสอ	pencil
ดิบ	raw
ดี	good
ดึก	late at night	about 9 pm - 3 am
ดื่ม	drink	formal
ดู	watch, look	
เดียว	only one	after CL
เดี๋ยว	moment	
เดือน	month	
เดือนที่แล้ว	last month	
เดือนหน้า	next month	
แดง	red	
ได้	get, can, get to V	
ตรง	straight, exactly	
ตลาด	market	
ต่อ	connect, continue
ต้อง	must	deontic and epistemic
ตอน	at, when	usually temp. preposition
ตั้งแต่	since, from	usually temporal
ตัว	body; CL for animanls, clothes, letters
ตี	hit, beat, o'clock	1 am - 5 am
ตื่น	wake up	intrans.
ตุลาคม	October	
แต่	but, only	
แต่เช้า	(since) early morning	
โต๊ะ	table
ใต้	under, south
ถึง	arrive, until, although	temp and loc; concessive
ถูก	hit (a mark); cheap, correct
ทาง	way, direction
ทาน	eat	formal
ทำ	do, make	
ทำงาน	work	v.
ทำไม	why?
ที	time	dt. Mal
ที่	at, in (loc), that, to (subordinator)
ที่นั่น	there
ที่นี่	here
ที่โน่น	over there (yonder)
ที่แล้ว	last, past	with temporal expression
ที่ไหน	where?
ทุก	every	with CL
ทุ่ม	o'clock	7 pm - 11 pm
เทา	grey	
เท่า	as much as	
เท่าไร	how much?
เที่ยง	upright; noon	
เที่ยงคืน	midnight	
เที่ยว	round; go out for fun	n., v.
โทรทัศน์ (ทีวี)	television, TV
โทรศัพท์	telephone, call (by phone)	as v. usually โทร.
ไทย	Thai
ธนาคาร	bank	
ธันวาคม	December	
นอน	sleep, lie down	
นะ	emphatic particle
นัด	make an appointment	
นั่น	that one, there
นั้น	that	with noun or CL
นาที	minute	
นาฬิกา	watch, clock, o'clock
น้ำ	water
น้ำแข็ง	ice	
น้ำเงิน	dark blue	
น้ำตาล	sugar, brown	
น้ำส้ม	orange juice; vinegar	
นิดหน่อย	a little bit	
นี่	this one, here
นี้	this	with noun or CL
โน่น	that one over there
โน้น	that (more distant)	with noun or CL
ใน	in
บน	on
บอก	tell
บะหมี่	yellow noodles	
บาท	Baht
บ้าน	house
บ่าย	afternoon	1-3 pm
บิน	fly	v.
เบียร์	beer	
โบสถ์	church	
ประเทศ	country
ประมาณ	about, approximate	
ปลุก	wake up	transitive
ปัญหา	problem
ปากกา	pen
ปี	year	
เป็น	to be (something)
ไป	go	movement away from speaker
ไปรษณีย์	post office	
ผม	I (male speaker)
ผิด	wrong
แผนที่	map
ฝรั่ง	Western, European	
ฝรั่งเศส	French
พจนานุกรม (ดิก)	dictionary
พรุ่งนี้	tomorrow	
พฤษภาคม	May	พรึด-สะ-พา-คม
พฤสจิกายน	November	พรึด-สะ-จิ-กา-ยน
พฤหัส(บดี)	Thursday, Jupiter	พะ-รึ-หัด-สะ-บอ-ดี
พวก	group (plural marker)
พ่อ	father
พุธ	Wednesday, Mercury	
พูด	speak	
เพื่อน	friend	
แพง	expensive
ฟ้า	sky, light blue	
แฟน	girlfriend, boyfriend, lover	
แฟรงค์	Franc
ภาษา	language
มกราคม	January	มก-กะ-รา-คม, มะ-กะ-รา-คม
ม่วง	purple	
มหาวิทยาลัย	university	มะ-หา-วิด-ทะ-ยา-ไล
มัน	it, he, she (impolite)
มา	come	movement toward speaker
มาก	much, many, very
มากมาย	many, a lot
มิถุนายน	June	
มี	have, there is
มีนาคม	March	
เมษายน	April	เม-สา-ยน
เมื่อ	when, on	temporal preposition, past reference
เมื่อกี้	a moment ago	
เมือง	town, city, country
เมื่อไร	when?	
เมื่อวาน	yesterday	
แม่	mother
โมง	o'clock	6 am - 6 pm 
ไม่	not (before verb to be negated)
ไม่เป็นไร	don't worry, it's OK, you're welcome
ยัง	still, yet
ยาก	difficult
ยินดี	be pleased
ยินดีที่ได้รู้จัก	glad to meet you
ยุ่ง	busy, disturb	
เยน	Yen
เย็น	cool, evening	
เยอรมัน	German
รถ	car, vehicle	
รถเก๋ง, รถยนต์	car	
รวย	rich
ระหว่าง	between
รัก	love
รับ	receive, pick up	
ร้าน	shop	
ร้านอาหาร	restaurant	
ราวๆ	around, about	
รู้	know (something)	
รู้เรื่อง	know what's going on, know what it is all about
รู้จัก	know (someone)
รูป, ภาพ	picture, photo
เร็ว	quick, fast	
เรา, พวกเรา	we
เรียน	learn	
เรื่อง	story, affair
โรง	big building	
โรงพยาบาล	hospital	
โรงเรียน	school	
โรงแรม	hotel	
โรงหนัง	movie theatre, cinema	
ล่ะ	and what about ...?
ลาว	Laotian
เล่าเรียน	learn, study
แล้ว	already, now, and then	indicating complete change of situation, new situation (nsit) marker, sequential
วัด	temple	
วัน	day	no classifier needed
วันหยุด	holiday	
ว่า	say, subordinator
ว่าง	be free	
วินาที	second	n.
เวลา	time	
แว่นตา	glasses
ศุกร์	Friday, Venus	
ส่ง	send
สนาม	field, open place	
สนามบิน	airport	
สบาย	be well, comfortable
ส้ม	orange	
สมอง	brain
สมุด	notebook
สวัสดี	hello, goodbye
สวิส, สวิตเซอร์แลนด์	Swiss, Switzerland
สอน	teach	
สัปดาห์	week	formal
สาย	late, late morning	about 8-11 am
สิงหาคม	August	
สี	colour	
เสาร์	Saturday, Saturn	
หน่อย	a bit	
หนัง	skin, leather, movie	
หนังสือ	book, writing
หนังสือพิมพ์	newspaper
หน้า	face, in front, next	
หยุด	stop	
หรือ	or	question particle
หลัง	back, after, behind	
หวาน	sweet	
ห้อง	room
ห้องนอน	bedroom
ห้องน้ำ	bathroom
เหลือง	yellow	
ให้	give, benefactive (postverbal), causative (preverbal)
ไหน	which, where?
ไหม, มั๊ย	question particle
อเมริกา	American
อย่างไร	how?
อยู่	to be (somewhere), stay, remain; temporary aspect
อร่อย	delicious
อะไร	what?
อังกฤษ	English, British	อัง-กริด
อังคาร	Tuesday, Mars	
อัน	piece, thing (general classifier)
อันนี้	this one
อาทิตย์	Sunday, Sun, week	
อ่าน	read	
อาหาร	food	
อีก	another, again	
อีกที	once more, again	
เอง	self
เอา	take, want to have	 
